1, 1, 1, 1, 1, 1, 1, 1, 1, 1, 1, 1, 1, 1, 1, 1, 1, 1, 1, 1, 1, 1, 1, 1, 1, 1, 1, 1, 1, 1, 1, 1, 1, 1, 1, 1, 1, 1, 1, 1, 1, 1, 1, 1, 1, 1, 1, 1, 1, 1, 1, 1, 1, 1, 1, 1, 1, 1, 1, 1, 1, 1, 1, 1, 1, 1, 1, 1, 1, 1, 1, 1, 1, 1, 1, 1, 1, 1, 1, 1, 1, 1, 1, 1, 1, 1, 1, 1, 1, 1, 1, 1, 1, 1, 1, 1, 1, 1, 1, 1, 1, 1, 1, 1, 1, 1, 1, 1, 1, 1, 1, 1, 1, 1, 1, 1, 1, 1, 1, 1, 1, 1, 1, 1, 1, 1, 1, 1, 1, 1, 1, 1, 1, 1, 1, 1, 1, 1, 1, 1, 1, 1, 1, 1, 1, 1, 1, 1, 1, 1, 1, 1, 1, 1, 1, 1, 1, 1, 1, 1, 1, 1, 1, 1, 1, 1, 1, 1, 1, 1, 1, 1, 1, 1, 1, 1, 1, 1, 1, 1, 1, 1, 1, 1, 1, 1, 1, 1, 1, 1, 1, 1, 1, 1, 1, 1, 1, 1, 1, 1, 1, 1, 1, 1, 1, 1, 1, 1, 1, 1, 1, 1, 1, 1, 1, 1, 1, 1, 1, 1, 1, 1, 1, 1, 1, 1, 1, 1, 1, 1, 1, 1, 1, 1, 1, 1, 1, 1, 1, 1, 1, 1, 1, 1, 1, 1, 1, 1, 1, 1, 1, 1, 1, 1, 1, 1, 1, 1, 1, 1, 1, 1, 1, 1, 1, 1, 1, 1, 1, 1, 1, 1, 1, 1, 1, 1, 1, 1, 1, 1, 1, 1, 1, 1, 1, 1, 1, 1, 1, 1, 1, 1, 1, 1, 1, 1, 1, 1, 1, 1
~
12, 12, 1, 12, 12, 1, 12, 12, 1, 12, 12, 1, 12, 12, 1, 12, 12, 1, 12, 12, 1, 12, 12, 1, 12, 12, 1, 12, 12, 1, 12, 12, 1, 12, 12, 1, 12, 12, 1, 12, 12, 1, 12, 12, 1, 12, 12, 1, 12, 12, 1, 12, 12, 1, 12, 12, 1, 12, 12, 1, 12, 12, 1, 12, 12, 1, 12, 12, 1, 12, 12, 1, 12, 12, 1, 12, 12, 1, 12, 12, 1, 12, 12, 1, 12, 12, 1, 12, 12, 1, 12, 12, 1, 12, 12, 1, 12, 12, 1, 12, 12, 1, 12, 12, 1, 12, 12, 1, 12, 12, 1, 12, 12, 1, 12, 12, 1, 12, 12, 1, 12, 12, 1, 12, 12, 1, 12, 12, 1, 12, 12, 1, 12, 12, 1, 12, 12, 1, 12, 12, 1, 12, 12, 1, 12, 12, 1, 12, 12, 1, 12, 12, 1, 12, 12, 1, 12, 12, 1, 12, 12, 1, 12, 12, 1, 12, 12, 1, 12, 12, 1, 12, 12, 1, 12, 12, 1, 12, 12, 1, 12, 12, 1, 12, 12, 1, 12, 12, 1, 12, 12, 1, 12, 12, 1, 12, 12, 1, 12, 12, 1, 12, 12, 1, 12, 12, 1, 12, 12, 1, 12, 12, 1, 12, 12, 1, 12, 12, 1, 12, 12, 1, 12, 12, 1, 12, 12, 1, 12, 12, 1, 12, 12, 1, 12, 12, 1, 12, 12, 1, 12, 12, 1, 12, 12, 1, 12, 12, 1, 12, 12, 1, 12, 12, 1, 12, 12, 1, 12, 12, 1, 12, 12, 1, 12, 12, 1, 12, 12, 1, 12, 12, 1, 12, 12, 1, 12, 12, 1, 12, 12, 1, 12, 12, 1, 12, 12, 1, 12, 12, 1, 12, 12, 1, 12, 12, 1, 12, 12, 1
~
10, 10, 10, 10, 10, 10, 10, 10, 10, 10, 10, 10, 10, 10, 10, 10, 10, 10, 10, 10, 10, 10, 10, 10, 10, 10, 10, 10, 10, 10, 10, 10, 10, 10, 10, 10, 10, 10, 10, 10, 10, 10, 10, 10, 10, 10, 10, 10, 10, 10, 10, 10, 10, 10, 10, 10, 10, 10, 10, 10, 10, 10, 10, 10, 10, 10, 10, 10, 10, 10, 10, 10, 10, 10, 10, 10, 10, 10, 10, 10, 10, 10, 10, 10, 10, 10, 10, 10, 10, 10, 10, 10, 10, 10, 10, 10, 10, 10, 10, 10, 10, 10, 10, 10, 10, 10, 10, 10, 10, 10, 10, 10, 10, 10, 10, 10, 10, 10, 10, 10, 10, 10, 10, 10, 10, 10, 10, 10, 10, 10, 10, 10, 10, 10, 10, 10, 10, 10, 10, 10, 10, 10, 10, 10, 10, 10, 10, 10, 10, 10, 10, 10, 10, 10, 10, 10, 10, 10, 10, 10, 10, 10, 10, 10, 10, 10, 10, 10, 10, 10, 10, 10, 10, 10, 10, 10, 10, 10, 10, 10, 10, 10, 10, 10, 10, 10, 10, 10, 10, 10, 10, 10, 10, 10, 10, 10, 10, 10, 10, 10, 10, 10, 10, 10, 10, 10, 10, 10, 10, 10, 10, 10, 10, 10, 10, 10, 10, 10, 10, 10, 10, 10, 10, 10, 10, 10, 10, 10, 10, 10, 10, 10, 10, 10, 10, 10, 10, 10, 10, 10, 10, 10, 10, 10, 10, 10, 10, 10, 10, 10, 10, 10, 10, 10, 10, 10, 10, 10, 10, 10, 10, 10, 10, 10, 10, 10, 10, 10, 10, 10, 10, 10, 10, 10, 10, 10, 10, 10, 10, 10, 10, 10, 10, 10, 10, 10, 10, 10, 10, 10, 10, 10, 10, 10, 10, 10, 10, 10, 10, 10
~
10, 0, 0, 10, 0, 0, 10, 0, 0, 10, 0, 0, 10, 0, 0, 10, 0, 0, 10, 0, 0, 10, 0, 0, 10, 0, 0, 10, 0, 0, 10, 0, 0, 10, 0, 0, 10, 0, 0, 10, 0, 0, 10, 0, 0, 10, 0, 0, 10, 0, 0, 10, 0, 0, 10, 0, 0, 10, 0, 0, 10, 0, 0, 10, 0, 0, 10, 0, 0, 10, 0, 0, 10, 0, 0, 10, 0, 0, 10, 0, 0, 10, 0, 0, 10, 0, 0, 10, 0, 0, 10, 0, 0, 10, 0, 0, 10, 0, 0, 10, 0, 0, 10, 0, 0, 10, 0, 0, 10, 0, 0, 10, 0, 0, 10, 0, 0, 10, 0, 0, 10, 0, 0, 10, 0, 0, 10, 0, 0, 10, 0, 0, 10, 0, 0, 10, 0, 0, 10, 0, 0, 10, 0, 0, 10, 0, 0, 10, 0, 0, 10, 0, 0, 10, 0, 0, 10, 0, 0, 10, 0, 0, 10, 0, 0, 10, 0, 0, 10, 0, 0, 10, 0, 0, 10, 0, 0, 10, 0, 0, 10, 0, 0, 10, 0, 0, 10, 0, 0, 10, 0, 0, 10, 0, 0, 10, 0, 0, 10, 0, 0, 10, 0, 0, 10, 0, 0, 10, 0, 0, 10, 0, 0, 10, 0, 0, 10, 0, 0, 10, 0, 0, 10, 0, 0, 10, 0, 0, 10, 0, 0, 10, 0, 0, 10, 0, 0, 10, 0, 0, 10, 0, 0, 10, 0, 0, 10, 0, 0, 10, 0, 0, 10, 0, 0, 10, 0, 0, 10, 0, 0, 10, 0, 0, 10, 0, 0, 10, 0, 0, 10, 0, 0, 10, 0, 0, 10, 0, 0, 10, 0, 0, 10, 0, 0, 10, 0, 0, 10, 0, 0, 10, 0, 0, 10, 0, 0, 10, 0, 0
~
1, 1, 1, 1, 1, 1, 1, 1, 1, 1, 1, 1, 1, 1, 1, 1, 1, 1, 1, 1, 1, 1, 1, 1, 1, 1, 1, 1, 1, 1, 1, 1, 1, 1, 1, 1, 1, 1, 1, 1, 1, 1, 1, 1, 1, 1, 1, 1, 1, 1, 1, 1, 1, 1, 1, 1, 1, 1, 1, 1, 1, 1, 1, 1, 1, 1, 1, 1, 1, 1, 1, 1, 1, 1, 1, 1, 1, 1, 1, 1, 1, 1, 1, 1, 1, 1, 1, 1, 1, 1, 1, 1, 1, 1, 1, 1, 1, 1, 1, 1, 1, 1, 1, 1, 1, 1, 1, 1, 1, 1, 1, 1, 1, 1, 1, 1, 1, 1, 1, 1, 1, 1, 1, 1, 1, 1, 1, 1, 1, 1, 1, 1, 1, 1, 1, 1, 1, 1, 1, 1, 1, 1, 1, 1, 1, 1, 1, 1, 1, 1, 1, 1, 1, 1, 1, 1, 1, 1, 1, 1, 1, 1, 1, 1, 1, 1, 1, 1, 1, 1, 1, 1, 1, 1, 1, 1, 1, 1, 1, 1, 1, 1, 1, 1, 1, 1, 1, 1, 1, 1, 1, 1, 1, 1, 1, 1, 1, 1, 1, 1, 1, 1, 1, 1, 1, 1, 1, 1, 1, 1, 1, 1, 1, 1, 1, 1, 1, 1, 1, 1, 1, 1, 1, 1, 1, 1, 1, 1, 1, 1, 1, 1, 1, 1, 1, 1, 1, 1, 1, 1
~
0.0, 1.3082926e-2, 2.6163613e-2, 3.923982e-2, 5.2309312e-2, 6.536985e-2, 7.84192e-2, 9.145513e-2, 0.1044754, 0.1174778, 0.13046007, 0.14342001, 0.15635541, 0.16926403, 0.18214369, 0.19499217, 0.20780727, 0.2205868, 0.23332858, 0.24603042, 0.25869015, 0.2713056, 0.28387463, 0.29639503, 0.30886474, 0.32128155, 0.33364338, 0.3459481, 0.3581936, 0.3703778, 0.3824986, 0.39455393, 0.4065417, 0.4184599, 0.43030646, 0.4420794, 0.45377663, 0.4653962, 0.4769361, 0.48839435, 0.499769, 0.5110581, 0.5222597, 0.5333719, 0.5443929, 0.5553206, 0.56615335, 0.5768891, 0.58752614, 0.59806263, 0.6084967, 0.6188267, 0.6290507, 0.639167, 0.649174, 0.6590698, 0.6688528, 0.67852134, 0.6880737, 0.6975083, 0.7068235, 0.7160177, 0.7250894, 0.7340369, 0.7428588, 0.7515536, 0.7601197, 0.7685557, 0.7768601, 0.7850316, 0.7930687, 0.8009701, 0.8087343, 0.8163601, 0.82384616, 0.83119124, 0.83839405, 0.8454533, 0.8523679, 0.8591366, 0.8657582, 0.87223166, 0.8785558, 0.8847295, 0.89075184, 0.8966217, 0.902338, 0.9079, 0.9133065, 0.91855663, 0.9236496, 0.9285844, 0.93336034, 0.9379764, 0.94243205, 0.94672626, 0.9508585, 0.9548279, 0.9586339, 0.96227586, 0.965753, 0.96906495, 0.97221094, 0.9751905, 0.9780032, 0.9806485, 0.9831259, 0.985435, 0.9875755, 0.9895469, 0.9913489, 0.99298126, 0.9944436, 0.99573576, 0.99685746, 0.9978085, 0.9985888, 0.99919814, 0.9996364, 0.9999036, 0.9999997, 0.99992454, 0.99967825, 0.99926084, 0.9986724, 0.997913, 0.9969828, 0.995882, 0.9946106, 0.99316907, 0.9915575, 0.9897762, 0.98782545, 0.9857056, 0.9834171, 0.98096025, 0.97833544, 0.9755432, 0.972584, 0.9694583, 0.9661666, 0.9627096, 0.9590878, 0.95530176, 0.9513523, 0.94723994, 0.94296545, 0.93852955, 0.93393296, 0.92917657, 0.9242611, 0.9191874, 0.9139564, 0.908569, 0.90302604, 0.89732856, 0.89147747, 0.8854738, 0.8793186, 0.87301284, 0.86655766, 0.8599541, 0.8532034, 0.8463067, 0.83926505, 0.83207977, 0.8247521, 0.8172832, 0.8096745, 0.80192715, 0.7940425, 0.786022, 0.7778669, 0.7695787, 0.76115876, 0.75260854, 0.7439295, 0.7351231, 0.72619087, 0.71713436, 0.7079551, 0.69865465, 0.6892346, 0.6796966, 0.6700423, 0.6602732, 0.65039116, 0.6403978, 0.6302948, 0.62008387, 0.60976684, 0.59934545, 0.5888215, 0.5781967, 0.56747293, 0.55665207, 0.5457359, 0.5347263, 0.52362525, 0.5124345, 0.5011561, 0.48979184, 0.47834378, 0.46681386, 0.455204, 0.44351625, 0.4317526, 0.41991502, 0.40800557, 0.39602625, 0.3839792, 0.3718664, 0.35968995, 0.34745193, 0.3351544, 0.32279956, 0.31038946, 0.29792622, 0.28541198, 0.27284887, 0.2602391, 0.24758475, 0.23488803, 0.22215112, 0.20937616, 0.19656537, 0.18372095, 0.17084506, 0.15793994, 0.14500779, 0.1320508, 0.11907122, 0.10607126, 9.305315e-2, 8.00191e-2, 6.6971354e-2, 5.391215e-2, 4.0843718e-2, 2.7768293e-2, 1.4688115e-2, 1.6054226e-3